...#############
...............#
#..####..#..####
#..#..#..#.....#
####..#..####..#
#...........#..#
####..####..####
#.....#........#
#..#..#..####..#
#..#..#.....#..
#############..