...##########################################################
............#........#.....#................................#
####..#..####..#..#..####..#######..#..#..##########..#..####
#.....#..#..#..#..#..#.....#..#.....#..#..#..#..#.....#..#..#
#..####..#..#..####..#..####..#######..####..#..#..#..#..#..#
#..#..............#..#.....#..#..............#.....#..#.....#
#..####..#..####..#..####..#..#..##########..#############..#
#..#.....#..#.....#..#..#........#........#..#........#.....#
#..#######..#..####..#..#..#..##########..#######..####..#..#
#..#........#..#..#........#..#....................#.....#..#
#..####..####..#..#..#..#..#############..#######..#..####..#
#..#.....#.....#.....#..#..............#..#..#........#.....#
#..#..#######..#############..#############..####..#..####..#
#..#..#........#..............#..#........#..#..#..#..#..#..#
#..################..####..#..#..#..#######..#..#..####..#..#
#...........#..#........#..#.....#..............#.....#.....#
####..#######..#..#..#############..#..###################..#
#.....#.....#.....#.....#.....#.....#.....#...........#.....#
#######..##########..#######..#######..#######..####..#######
#........#........#..#.....#.....#..............#..#..#..#..#
#..#############..#..####..#..#..#..#..##########..####..#..#
#..#..#..#.....#.....#........#.....#...........#.....#..#..#
#..#..#..#..####..################..#######..####..#..#..#..#
#..#........#........#........#..#........#........#........#
#..#######..#######..####..#..#..##########..#..####..####..#
#...........#........#.....#..#..#..#..#.....#..#.....#.....#
#..#..#..#..#######..#..####..#..#..#..#..#############..#..#
#..#..#..#...........#.....#........#.....#..#..#.....#..#..#
####..####..#######..####..####..####..#..#..#..#..##########
#........#..#...........#.....#.....#..#.................#..#
#..#######..####..####..#..################..#..##########..#
#........#..#.....#..#..#.....#.....#.....#..#..#...........#
#############..####..#..#..####..####..#######..##########..#
#....................#....................#.....#..#..#.....#
#..###################..####..####..##########..#..#..####..#
#.....#........#..#..#..#.....#..#.....#.....#.....#........#
#..#######..#..#..#..####..#..#..####..#..####..#..#######..#
#.....#..#..#........#.....#........#........#..#........#..#
#..####..#..####..#######..####..####..####..####..#######..#
#..............#..#........#........#..#....................
##########################################################..
