...###########################################
......#.....#..#.....#........#........#..#..#
#..#..####..#..#..#..####..#..####..####..#..#
#..#..#...........#.....#..#.....#..#..#.....#
#..####..####..####..####..####..#..#..####..#
#.....#..#........#.....#..#..#..............#
#..#..#..####..#######..#..#..#..#..#######..#
#..#.....#..#.....#..#.....#..#..#........#..#
#..####..#..#######..####..#..#..#..#..#..#..#
#..#..#..#.....#..#........#.....#..#..#..#..#
#..#..####..####..#..#..#..#..#..####..####..#
#.....#..#........#..#..#..#..#..#........#..#
#..####..####..####..#..####..#..#..##########
#..#.....#.....#..#..#..#..#..#..#.....#.....#
####..####..#..#..####..#..#..#..#######..#..#
#........#..#.....#........#..#........#..#..#
#..##########..#..##########..#######..#..#..#
#..#..#........#........#.....#..#........#..#
#..#..#..#..####..####..#######..#..##########
#........#.....#..#.....#..#.....#........#..#
#..#..#######..#..####..#..#..#######..#..#..#
#..#..#........#.....#..#........#..#..#..#..#
################..####..#..####..#..#..####..#
#..#........#........#.....#..#..#...........#
#..#..#..#..#..#..#..####..#..#..####..####..#
#.....#..#.....#..#.....#.....#..#..#..#.....#
####..################..#..#..####..#..####..#
#........#...........#..#..#...........#.....#
####..####..#..#..#..##########..####..#..####
#...........#..#..#........#........#..#.....
###########################################..
