...############################
...#..#..#...........#........#
#..#..#..####..#############..#
#.....#..#.....#.....#.....#..#
#..####..#..#..#..#..#..####..#
#........#..#.....#...........#
####..#..#######..#..#######..#
#.....#.....#.....#..#..#.....#
#..#..#..#..#..#######..#..####
#..#..#..#..#........#..#..#..#
#..#..#..####..####..#..#..#..#
#..#..#.....#.....#..#........#
####..#######..#..#######..#..#
#..............#..#.....#..#..#
####..#..####..#..####..#..#..#
#.....#..#..#..#..#........#..#
#..#..####..#######..##########
#..#..#.....#..#.....#..#..#..#
#..####..#..#..####..#..#..#..#
#........#........#...........
############################..